10
100
....t...ot
//////////
//////////
..t.....o.
...t.to...
//////////
//////////
t...o...t.
//////////
..to...t..
....t...ot
//////////
//////////
..t.....o.
...t.to...
//////////
//////////
t...o...t.
//////////
..to...t..
....t...ot
//////////
//////////
..t.....o.
...t.to...
//////////
//////////
t...o...t.
//////////
..to...t..
....t...ot
//////////
//////////
..t.....o.
...t.to...
//////////
//////////
t...o...t.
//////////
..to...t..
....t...ot
//////////
//////////
..t.....o.
...t.to...
//////////
//////////
t...o...t.
//////////
..to...t..
....t...ot
//////////
//////////
..t.....o.
...t.to...
//////////
//////////
t...o...t.
//////////
..to...t..
....t...ot
//////////
//////////
..t.....o.
...t.to...
//////////
//////////
t...o...t.
//////////
..to...t..
....t...ot
//////////
//////////
..t.....o.
...t.to...
//////////
//////////
t...o...t.
//////////
..to...t..
....t...ot
//////////
//////////
..t.....o.
...t.to...
//////////
//////////
t...o...t.
//////////
..to...t..
....t...ot
//////////
//////////
..t.....o.
...t.to...
//////////
//////////
t...o...t.
//////////
..to...t..

